1111111111111
10000000000C1
1000111111001
1P001CE000001
1111111111111