111111111
100010C01
10P001001
10C010E01
100001001
111111111