1111111111111
10010PP000011
10C0011111001
1010111E0C001
1111111111111