111111111
101000C01
11P100001
101000E01
100000001
111111111