1111110111111
10010000000C1
1000011111000
1P0011E000001
0111111111111