11111111111
100000P0001
1C00001111
1111E11